ana : je
walakin : mais
fin : ou
O : et
7ta : et
illa : ni
7it : car
m3a : avec
dheb : l'or
aurjou3 : hors-jeu
babor : bateau
balcone : balcon
baliza : valise
ballone : ballon
balone : ballon
balto : manteau
banda : bande
banka : banque
barabole : Parabole
barassioun : operation
barbrise : Pare-brise
barmeta : barmaid
barra : barriere
barteyya : partie
bart9iz : Portugais
barwita : brouette
baspour : passeport
kolou : mangez
koul : mange
klit : mangeai
kanakel : entrain de manger
katakli : entrain de manger
kataklo : entrain de manger
n3es : dort
n3so : dormez
na3es : endormi
na3essa : endormie
na3essine : endormis
fi9 : reveille
fi9ou : reveillez
faye9 : reveille
faye9a : reveillee 
faye9in : reveilles
chrb : boit
chrbo : buvez
chareb : ivre
d7k : rigole
d7ko : rigolez
da7ek : souriant
da7eka : souriante
da7ekine : heureux
hrb : fuit
hrbo : fuyez
hareb : entrain de fuir
harebin : entrain de fuir
hareba : entrain de fuir 
l3b : joue
l3bo : jouez
la3eb : entrain de jouer
la3eba : entrain de jouer
la3ebine : entrain de jouer
drb : frappe
drbo : frappez
mdareb : en dispute
mdareba : en dispute
mdarbin : en dispute
ktb : ecrit
ktbo : ecrivez
kankteb : entrain d'ecrire
kateba : entrain d'ecrire
katebin : entrain d'ecrire
sm3 : ecoute
sm3o : ecoutez
kansme3 : entrain d'ecouter
ch3l : allume
ch3lo : allumez
cha3el : furieux
cha3ela : enerve
tfi : eteint
tafi : fatigue
tfiw : eteignez
tafya : fatiguee
7sb : calcule
7sbo : calculez
3awd : repete
3awdo : repetez
lbss : habille
lbssou : habillez
labess : habille
labessa : habillee
7bs : arrete
7bsou : arretez
7abess : bloque
7abessa : bloquee
glss : assit
glssou : asseyez
galess : assis
galessa : assise
galessine : assis
howa : il
hia : elle
nta : tu
ntia : tu
7na : nous
houma : ils
ntouma : vous
knt : j`etais
knti : tu etais
kan : il etait
kanet : elle etait
kna : nous etions
kntou : vous etiez
kanou : ils etaient
fr7an : heureux
fr7ana : heureuse
fr7anin : heureux
fr7anat : heureuses
mchoki : choque
mchokia : choquee
mchokin : choques
zwin : beau
zwina : belle
zwinin : beaux
zwinat : belles
fdar : dans la maison
fdarna : dans notre maison 
matchkora : match de foot-ball
tiniss : le tennis
chfara : des voleurs
bolis : de la police
tacos : tacos
leghda : le dejeuner
le3sha : le diner
3lihom : sur eux
3lina : sur nous
lma : de l'eau
monada : une limonade
3assir : un jus
sdari : le lit
lbit : la chambre
salon : le salon
zen9a : la rue
mdrassa : l'ecole
mktaba : la bibliotheque
9issem : la classe
bilal : bilal
aghani : de la musique
doross : les leçons
telfaza : la tele
dow : la lumiere
lflouss : l'argent
7wayej : des vetements
9dam : ancien
9dim : ancien
9dima : ancienne
jdad : nouveau
jdid : nouveau
jdida : nouvelle
hdra : paroles
korsi : la chaise
lard : sur terre